XXXXXXXXXX
X     X  X
X XX XX XX
X  X  X  X
XX   XXX X
X  X  XX X
X XXX X  X
X  XX X XX
XX  X    X
XXXFXXXXXX